{
	"name": "The Sunken",
	"id": "0",
	"turns": "20",
	"bg": "bg0",
	"author": "",
	"desc": "Das intro Level",
	"data": [
		[ ".", ".", "#", " ", "#", ".", ".", ".", ".", " " ],
		[ ".", ".", ".", "#", ".", ".", "#", ".", "z", " " ],
		[ ".", "#", ".", "+", ".", "p", "#", ".", ".", " " ],
		[ ".", ".", ".", ".", ".", ".", ".", ".", ".", " " ],
		[ ".", "#", ".", ".", "+", "x", ".", ".", ".", " " ],
		[ " ", " ", " ", " ", " ", " ", " ", " ", " ", " " ],
		[ " ", " ", " ", " ", " ", " ", " ", " ", " ", " " ],
		[ " ", " ", " ", " ", " ", " ", " ", " ", " ", " " ],
		[ " ", " ", " ", " ", " ", " ", " ", " ", " ", " " ],
		[ " ", " ", " ", " ", " ", " ", " ", " ", " ", " " ]
	]
}