{
	"name": "The Sunken",
	"id": "1",
	"turns": "10",
	"bg": "bg0",
	"author": "",
	"desc": "Das intro Level",
	"data": [
		[ ".", ".", "#", " ", " ", ".", ".", ".", ".", " " ],
		[ ".", ".", ".", " ", ".", ".", "#", ".", "z", " " ],
		[ ".", "#", ".", "+", ".", "p", "#", ".", ".", " " ],
		[ ".", ".", ".", ".", ".", ".", ".", ".", ".", " " ],
		[ ".", "#", ".", ".", "+", "x", ".", ".", ".", " " ],
		[ " ", " ", " ", " ", " ", " ", " ", " ", " ", " " ],
		[ " ", " ", " ", " ", " ", " ", " ", " ", " ", " " ],
		[ " ", " ", " ", " ", " ", " ", " ", " ", " ", " " ],
		[ " ", " ", " ", " ", " ", " ", " ", " ", " ", " " ],
		[ " ", " ", " ", " ", " ", " ", " ", " ", " ", " " ]
	]
}